24,7,6
START,0,2,B,A
B,1,2,C,K
C,1,3,D,E
D,1,4,A,A
E,2,3,F,J
F,2,4,G,H
G,2,5,A,A
H,3,4,A,I
I,4,4,A,A
J,2,2,A,A
K,1,1,L,A
L,2,1,N,M
M,2,0,A,A
N,3,1,O,A
O,3,2,A,P
P,4,2,Q,V
Q,4,3,R,S
R,3,3,A,O
S,5,3,T,U
T,5,4,A,A
U,5,2,W,A
V,4,1,N,A
EXIT,6,2,A,A